15 30
##############################
#O                          O#
#                            #
#                  ##        #
#                   ##       #
#                    ##      #
#            ##              #
#          ####    X         #
#        #####               #
#         ###                #
#                    ###     #
#                    #       #
#                    #       #
#O                          O#
##############################
