##########
#O# #   ##
#        #
#####   ##
#X       #
##########