####################
#O                 #
#     ##      ##   #
#   #####     #    #
#    ##     ##     #
#                  #
#    #  ###    #   #
#      ## ##       #
#     ###  ##   #  #
#  #    ####       #
#         #      ###
#     ##       #   #
#    ## #    #   X #
#            #     #
####################